1111111111111111111
1P00000C10000000001
10001000100001010C1
1111100100100100001
1000001001000101001
1001111001001001001
1000000001C01C010E1
1111111111111111111
