1111111111111
1001000000001
1000011111101
1P00110000101
10001E0010001
1111111111111
