11111111111
1E000C00001
10100101P01
10100100101
10000000001
11111111111
