1111111111111
10010000000C1
1000011111101
1000110000101
100C1E0010001
1111111111111
